BBBBLLGGGGG
BBBBLLGGGGG
BBBLLLGGGGG
GGGGGGGGGGG
GGGGGGGGGGG
GGGGGGWWWWW
BBBBBBWGGGG
BBBBBBWGGGG
BBBBBBWGGGG

..DS..TSSSS
.SSS......S
..........A
SSS.....T.S
.....F.....
...........
..F........
..D.....FD.
S..........

...........
.......r...
...........
...........
...........
..MS.......
...H.......
.....r....r
...........
